..*............
.##.##########.
.##.##########.
.##.......####.
.#####.##.####.
.#####.##......
.###...#######.
.#...#.......#.
.#####.###.###.
....##.###.###.
.##.#..###G###.
.##.#.########.
.##...#....###.
.######.######.
...............
