. . * . . . . . . . . . . . .
. # # . # # # # # # # # # # .
. # # . # # # # # # # # # # .
. # # . . . . . . . # # # # .
. # # # # # . # # . # # # # .
. # # # # # . # # . . . . . .
. # # # . . . # # # # # # # .
. # . . . # . . . . . . . # .
. # # # # # . # # # . # # # .
. . . . # # . # # # . # # # .
. # # . # . . # # # G # # # .
. # # . # . # # # # # # # # .
. # # . . . # . . . . # # # .
. # # # # # # . # # # # # # .
. . . . . . . . . . . . . . .
