# # # . # # # # # # # # # # #
# # # . # # # # # # # # # # #
# # # . # # # # # # # # # # #
# # # . . . . . . . # # # # #
# # # # # # . # # . # # # # #
# # # # # # . # # . . . . . .
# # # # . . . # # # # # # # #
# # . . . # . . . . . . . # #
# # # # # # . # # # . # # # #
. . . . # # . # # # . # # # #
# # # . # . . # # # . # # # #
# # # . # . # # # # . # # # #
# # # . . . # . . . . # # # #
# # # # # # # . # # # # # # #
# # # # # # # . # # # # # # #
# # # . . . . . # # # # # # #
# # # . # # # # # # # # # # #
# # # . # # # # # # # # # # #
# # # . . . . . . . # # # # #
# # # # # # . # # . # # # # #
# # # # # # . # # . . . . . .
# # # # . . . # # # # # # # #
# # . . . # . . . . . . . # #
# # # # # # . # # # . # # # #
# . . . # # . # # # . # # # #
# # # . # . . # # # . # # # #
# # # . # . # # # # # # # # #
# # # . . . # . . . . # # # #
# # # # # # # . # # # # # # #
# # # # # # # . # # # # # # #
