# # # . # # # # # # # # # # #
# # # . # # # # # # # # # # #
# # # . # # # # # # # # # # #
# # # . . . . . . . # # # # #
# # # # # # . # # . # # # # #
# # # # # # . # # . . . . . .
# # # # . . . # # # # # # # #
# # . . . # . . . . . . . # #
# # # # # # . # # # . # # # #
. . . . # # . # # # . # # # #
# # # . # . . # # # G # # # #
# # # . # . # # # # # # # # #
# # # . . . # . . . . # # # #
# # # # # # # . # # # # # # #
# # # # # # # . # # # # # # #
